************************
*                      *
*                      *
*                      *
*                      *
*                      *
*                      *
*                      *
*         P            *
*                      *
*         M            *
*                      *
*                      *
*                      *
*         T            *
*                      *
*                      *
*                      *
*                      *
*                      *
*                      *
************************
